# Note padding of 7 0 bits added to end of each (25 * 17) grid

000000000000000000000000000000000000000000000000000000001100111110011000000000001010010001001010000000001001001000100100100000001000100100010010001000001000010010001001000010000111111001000100111111000000000000100010000000000001111110010001001111110000100001001000100100001000001000100100010010001000000010010010001001001000000000101001000100101000000000001100111110011000000000000000000000000000000000000000000000000000000000000000
000000000000000000000000000000000000000000000000000000010000000000000100000000010000000000000001000000010000000000000000010000010000000000000000000100000010000000000000001000000000100000000000001000000000001000000000001000000000001000000000000010000000001000000000000000100000010000000000000000000100000100000000000000000100000001000000000000000100000000010000000000000100000000000000000000000000000000000000000000000000000000000000
000000000000000000000000000000000000000000000000000000000000000000000000000001111001111011110011110000100100100101001001001000010010010010100100100100001111111111011111111110000000100100000001001000000000010010000000100100000000001001000000010010000000111111111101111111111000010010010010100100100100001001001001010010010010000111111111101111001111000000000000000000000000000000000000000000000000000000000000000000000000000000000000
000000000000000000000000000000000000000000000000000011111100000000011111100001111110000000001111110000111111000000000111111000011111100000000011111100001111111111111111111110000111111111111111111111000000001100000000011000000001111111111111111111110000111111111111111111111000011111100000000011111100001111110000000001111110000111111000000000111111000011111100000000011111100000000000000000000000000000000000000000000000000000000000
000000000000000000000000001111111000000000111111100100000100000000010000010010000010000000001000001001000001000000000100000100100000101111111010000010010000010100000101000001001111111010000010111111100000000001000001000000000011111110100000101111111001000001010000010100000100100000101111111010000010010000010000000001000001001000001000000000100000100100000100000000010000010011111110000000001111111000000000000000000000000000000000